,Labor Force,Employed,Unemployed,Unemployment Rate(%),Labor Force Participation Rate(%),Employment to Population Rate(%),Date
0,2788405,2634738,153667,5.5,65.6,62.0,1980-01-01
1,2815303,2643849,171454,6.1,66.1,62.0,1980-02-01
2,2811899,2652053,159846,5.7,65.9,62.1,1980-03-01
3,2827282,2670416,156866,5.5,66.1,62.4,1980-04-01
4,2865216,2684502,180714,6.3,66.9,62.6,1980-05-01
5,2896804,2682762,214042,7.4,67.5,62.5,1980-06-01
6,2928082,2692601,235481,8.0,68.1,62.7,1980-07-01
7,2911515,2708467,203048,7.0,67.6,62.9,1980-08-01
8,2850045,2672727,177318,6.2,66.1,62.0,1980-09-01
9,2863074,2680427,182647,6.4,66.3,62.1,1980-10-01
10,2853103,2669798,183305,6.4,66.0,61.8,1980-11-01
11,2855578,2685690,169888,5.9,66.0,62.1,1980-12-01
12,2832962,2632205,200757,7.1,65.4,60.7,1981-01-01
13,2855843,2649987,205856,7.2,65.8,61.1,1981-02-01
14,2869584,2680451,189133,6.6,66.0,61.7,1981-03-01
15,2879487,2715206,164281,5.7,66.1,62.4,1981-04-01
16,2908928,2738508,170420,5.9,66.7,62.8,1981-05-01
17,2925100,2740588,184512,6.3,67.0,62.8,1981-06-01
18,2950304,2785895,164409,5.6,67.5,63.7,1981-07-01
19,2944524,2786172,158352,5.4,67.3,63.7,1981-08-01
20,2865162,2723868,141294,4.9,65.4,62.1,1981-09-01
21,2924437,2724408,200029,6.8,66.6,62.1,1981-10-01
22,2938561,2716030,222531,7.6,66.9,61.8,1981-11-01
23,2924980,2693555,231425,7.9,66.5,61.2,1981-12-01
24,2897451,2620833,276618,9.5,65.8,59.5,1982-01-01
25,2915103,2636949,278154,9.5,66.1,59.8,1982-02-01
26,2924171,2645837,278334,9.5,66.2,59.9,1982-03-01
27,2900129,2656725,243404,8.4,65.6,60.1,1982-04-01
28,2956053,2694776,261277,8.8,66.7,60.8,1982-05-01
29,2967684,2687617,280067,9.4,66.9,60.6,1982-06-01
30,3024921,2728599,296322,9.8,68.1,61.4,1982-07-01
31,2999845,2731281,268564,9.0,67.5,61.4,1982-08-01
32,2935679,2687320,248359,8.5,66.0,60.4,1982-09-01
33,2930516,2658087,272429,9.3,65.8,59.7,1982-10-01
34,2937336,2646151,291185,9.9,65.9,59.4,1982-11-01
35,2915570,2642644,272926,9.4,65.4,59.2,1982-12-01
36,2890399,2584061,306338,10.6,64.7,57.9,1983-01-01
37,2896214,2578783,317431,11.0,64.8,57.7,1983-02-01
38,2890082,2596837,293245,10.1,64.6,58.1,1983-03-01
39,2898486,2631941,266545,9.2,64.8,58.8,1983-04-01
40,2930434,2662830,267604,9.1,65.4,59.4,1983-05-01
41,2979742,2702267,277475,9.3,66.5,60.3,1983-06-01
42,3022534,2765790,256744,8.5,67.3,61.6,1983-07-01
43,3019261,2771256,248005,8.2,67.2,61.7,1983-08-01
44,2982112,2750425,231687,7.8,66.2,61.1,1983-09-01
45,2970997,2738559,232438,7.8,65.9,60.7,1983-10-01
46,2992462,2755986,236476,7.9,66.3,61.0,1983-11-01
47,2988301,2767536,220765,7.4,66.1,61.2,1983-12-01
48,2954663,2724029,230634,7.8,65.2,60.1,1984-01-01
49,2975554,2752683,222871,7.5,65.6,60.7,1984-02-01
50,2995519,2786225,209294,7.0,65.9,61.3,1984-03-01
51,3001979,2809097,192882,6.4,65.9,61.7,1984-04-01
52,3048666,2857034,191632,6.3,66.9,62.7,1984-05-01
53,3071297,2866904,204393,6.7,67.3,62.8,1984-06-01
54,3104102,2905103,198999,6.4,67.9,63.5,1984-07-01
55,3079714,2887417,192297,6.2,67.2,63.0,1984-08-01
56,3035927,2852663,183264,6.0,66.1,62.1,1984-09-01
57,3037253,2845620,191633,6.3,66.0,61.9,1984-10-01
58,3041557,2849760,191797,6.3,66.0,61.8,1984-11-01
59,3035543,2849463,186080,6.1,65.7,61.7,1984-12-01
60,3016965,2808602,208363,6.9,65.2,60.7,1985-01-01
61,3043929,2835172,208757,6.9,65.7,61.2,1985-02-01
62,3067943,2875766,192177,6.3,66.1,61.9,1985-03-01
63,3061101,2891871,169230,5.5,65.8,62.2,1985-04-01
64,3108749,2927548,181201,5.8,66.7,62.8,1985-05-01
65,3125788,2936845,188943,6.0,66.9,62.9,1985-06-01
66,3171545,2981857,189688,6.0,67.8,63.7,1985-07-01
67,3151799,2989714,162085,5.1,67.3,63.9,1985-08-01
68,3131585,2981505,150080,4.8,66.8,63.6,1985-09-01
69,3152160,2998064,154096,4.9,67.2,63.9,1985-10-01
70,3155460,2996590,158870,5.0,67.2,63.8,1985-11-01
71,3146720,2995899,150821,4.8,67.0,63.7,1985-12-01
72,3098190,2944116,154074,5.0,65.9,62.6,1986-01-01
73,3136809,2949049,187760,6.0,66.6,62.6,1986-02-01
74,3132091,2961651,170440,5.4,66.5,62.8,1986-03-01
75,3136262,2970264,165998,5.3,66.5,63.0,1986-04-01
76,3173923,3002295,171628,5.4,67.2,63.6,1986-05-01
77,3223580,3041994,181586,5.6,68.2,64.4,1986-06-01
78,3273683,3089402,184281,5.6,69.2,65.3,1986-07-01
79,3244228,3080874,163354,5.0,68.5,65.0,1986-08-01
80,3193766,3036377,157389,4.9,67.3,64.0,1986-09-01
81,3207063,3045621,161442,5.0,67.5,64.1,1986-10-01
82,3211257,3041070,170187,5.3,67.5,63.9,1986-11-01
83,3204189,3048496,155693,4.9,67.3,64.0,1986-12-01
84,3187048,3012600,174448,5.5,66.8,63.2,1987-01-01
85,3213383,3035021,178362,5.6,67.3,63.5,1987-02-01
86,3223791,3057472,166319,5.2,67.4,63.9,1987-03-01
87,3224510,3077947,146563,4.5,67.3,64.3,1987-04-01
88,3279819,3128519,151300,4.6,68.4,65.2,1987-05-01
89,3307174,3148602,158572,4.8,68.9,65.6,1987-06-01
90,3351115,3202648,148467,4.4,69.7,66.6,1987-07-01
91,3331852,3189443,142409,4.3,69.2,66.2,1987-08-01
92,3273474,3146384,127090,3.9,67.9,65.3,1987-09-01
93,3304006,3173658,130348,3.9,68.4,65.7,1987-10-01
94,3300447,3165818,134629,4.1,68.3,65.5,1987-11-01
95,3275055,3152564,122491,3.7,67.7,65.1,1987-12-01
96,3258106,3098672,159434,4.9,67.2,64.0,1988-01-01
97,3285996,3140928,145068,4.4,67.8,64.8,1988-02-01
98,3276150,3150434,125716,3.8,67.5,64.9,1988-03-01
99,3277891,3168532,109359,3.3,67.4,65.2,1988-04-01
100,3313291,3190909,122382,3.7,68.1,65.5,1988-05-01
101,3361979,3237840,124139,3.7,69.0,66.4,1988-06-01
102,3423690,3292531,131159,3.8,70.2,67.5,1988-07-01
103,3394959,3274693,120266,3.5,69.5,67.0,1988-08-01
104,3339970,3234236,105734,3.2,68.3,66.2,1988-09-01
105,3345563,3235489,110074,3.3,68.4,66.1,1988-10-01
106,3352924,3234281,118643,3.5,68.4,66.0,1988-11-01
107,3333080,3222138,110942,3.3,68.0,65.7,1988-12-01
108,3323087,3183872,139215,4.2,67.7,64.9,1989-01-01
109,3333410,3203919,129491,3.9,67.8,65.2,1989-02-01
110,3342219,3224248,117971,3.5,67.9,65.5,1989-03-01
111,3352391,3236403,115988,3.5,68.1,65.7,1989-04-01
112,3390484,3267968,122516,3.6,68.8,66.3,1989-05-01
113,3443625,3311173,132452,3.8,69.8,67.1,1989-06-01
114,3477234,3346672,130562,3.8,70.4,67.7,1989-07-01
115,3451052,3328882,122170,3.5,69.8,67.3,1989-08-01
116,3387359,3278550,108809,3.2,68.4,66.2,1989-09-01
117,3404151,3294642,109509,3.2,68.7,66.5,1989-10-01
118,3406088,3290696,115392,3.4,68.7,66.3,1989-11-01
119,3385255,3276538,108717,3.2,68.2,66.0,1989-12-01
120,3390891,3255576,135315,4.0,67.2,64.5,1990-01-01
121,3432275,3294473,137802,4.0,67.9,65.1,1990-02-01
122,3440565,3316595,123970,3.6,67.9,65.5,1990-03-01
123,3438542,3317058,121484,3.5,67.8,65.4,1990-04-01
124,3490953,3360459,130494,3.7,68.6,66.1,1990-05-01
125,3528098,3387463,140635,4.0,69.3,66.5,1990-06-01
126,3557765,3405020,152745,4.3,69.8,66.8,1990-07-01
127,3513642,3375171,138471,3.9,68.8,66.1,1990-08-01
128,3478441,3344397,134044,3.9,68.0,65.4,1990-09-01
129,3500694,3340101,160593,4.6,68.3,65.1,1990-10-01
130,3490101,3324143,165958,4.8,68.0,64.7,1990-11-01
131,3484894,3313857,171037,4.9,67.8,64.4,1990-12-01
132,3452163,3237612,214551,6.2,67.0,62.8,1991-01-01
133,3491693,3265117,226576,6.5,67.7,63.3,1991-02-01
134,3490109,3268025,222084,6.4,67.6,63.3,1991-03-01
135,3505516,3304721,200795,5.7,67.8,63.9,1991-04-01
136,3525559,3316207,209352,5.9,68.0,64.0,1991-05-01
137,3577048,3358534,218514,6.1,68.9,64.7,1991-06-01
138,3621884,3395892,225992,6.2,69.7,65.3,1991-07-01
139,3581524,3380591,200933,5.6,68.8,65.0,1991-08-01
140,3561321,3373506,187815,5.3,68.3,64.7,1991-09-01
141,3568736,3378891,189845,5.3,68.4,64.7,1991-10-01
142,3556144,3349860,206284,5.8,68.1,64.1,1991-11-01
143,3531105,3325016,206089,5.8,67.5,63.6,1991-12-01
144,3522415,3274747,247668,7.0,67.3,62.6,1992-01-01
145,3547142,3292766,254376,7.2,67.7,62.8,1992-02-01
146,3552058,3316098,235960,6.6,67.7,63.2,1992-03-01
147,3552531,3342940,209591,5.9,67.6,63.7,1992-04-01
148,3595745,3369549,226196,6.3,68.4,64.1,1992-05-01
149,3664727,3417774,246953,6.7,69.6,64.9,1992-06-01
150,3694757,3455837,238920,6.5,70.1,65.6,1992-07-01
151,3664225,3435619,228606,6.2,69.4,65.1,1992-08-01
152,3614280,3405305,208975,5.8,68.3,64.4,1992-09-01
153,3615853,3415376,200477,5.5,68.2,64.4,1992-10-01
154,3620971,3408952,212019,5.9,68.2,64.2,1992-11-01
155,3597151,3399327,197824,5.5,67.6,63.9,1992-12-01
156,3559041,3334719,224322,6.3,66.8,62.6,1993-01-01
157,3591790,3372274,219516,6.1,67.3,63.2,1993-02-01
158,3581682,3382396,199286,5.6,67.0,63.3,1993-03-01
159,3585811,3397482,188329,5.3,67.0,63.5,1993-04-01
160,3628373,3437118,191255,5.3,67.7,64.1,1993-05-01
161,3672297,3470352,201945,5.5,68.4,64.6,1993-06-01
162,3701657,3511588,190069,5.1,68.8,65.3,1993-07-01
163,3664514,3488529,175985,4.8,68.0,64.7,1993-08-01
164,3604794,3449029,155765,4.3,66.7,63.9,1993-09-01
165,3628584,3467838,160746,4.4,67.1,64.1,1993-10-01
166,3635031,3475418,159613,4.4,67.1,64.1,1993-11-01
167,3620334,3468949,151385,4.2,66.7,63.9,1993-12-01
168,3590551,3402227,188324,5.2,66.0,62.6,1994-01-01
169,3616553,3433252,183301,5.1,66.4,63.1,1994-02-01
170,3615762,3447947,167815,4.6,66.3,63.2,1994-03-01
171,3625612,3472159,153453,4.2,66.4,63.6,1994-04-01
172,3669617,3508398,161219,4.4,67.1,64.1,1994-05-01
173,3707803,3533899,173904,4.7,67.7,64.5,1994-06-01
174,3731768,3557172,174596,4.7,68.0,64.8,1994-07-01
175,3726121,3560402,165719,4.4,67.8,64.8,1994-08-01
176,3700637,3551577,149060,4.0,67.2,64.5,1994-09-01
177,3724364,3575355,149009,4.0,67.5,64.8,1994-10-01
178,3733285,3582217,151068,4.0,67.5,64.8,1994-11-01
179,3713246,3576513,136733,3.7,67.0,64.6,1994-12-01
180,3676348,3507484,168864,4.6,66.3,63.2,1995-01-01
181,3702346,3536501,165845,4.5,66.6,63.6,1995-02-01
182,3713638,3561480,152158,4.1,66.7,64.0,1995-03-01
183,3710381,3562763,147618,4.0,66.5,63.9,1995-04-01
184,3729674,3568573,161101,4.3,66.8,63.9,1995-05-01
185,3779482,3604666,174816,4.6,67.5,64.4,1995-06-01
186,3829385,3639282,190103,5.0,68.3,64.9,1995-07-01
187,3782557,3612854,169703,4.5,67.4,64.3,1995-08-01
188,3755158,3601573,153585,4.1,66.7,64.0,1995-09-01
189,3790655,3636109,154546,4.1,67.2,64.5,1995-10-01
190,3793026,3626339,166687,4.4,67.2,64.2,1995-11-01
191,3773999,3617975,156024,4.1,66.7,64.0,1995-12-01
192,3771304,3559629,211675,5.6,66.6,62.8,1996-01-01
193,3790977,3606039,184938,4.9,66.8,63.5,1996-02-01
194,3816822,3642939,173883,4.6,67.1,64.1,1996-03-01
195,3833347,3663674,169673,4.4,67.3,64.3,1996-04-01
196,3884050,3710155,173895,4.5,68.1,65.0,1996-05-01
197,3921957,3747891,174066,4.4,68.6,65.6,1996-06-01
198,3957287,3772844,184443,4.7,69.1,65.9,1996-07-01
199,3916070,3757399,158671,4.1,68.3,65.5,1996-08-01
200,3897358,3746493,150865,3.9,67.8,65.2,1996-09-01
201,3931620,3782081,149539,3.8,68.3,65.7,1996-10-01
202,3936003,3778149,157854,4.0,68.3,65.5,1996-11-01
203,3913113,3770818,142295,3.6,67.8,65.3,1996-12-01
204,3897193,3721522,175671,4.5,67.4,64.3,1997-01-01
205,3918695,3741743,176952,4.5,67.7,64.6,1997-02-01
206,3954752,3795294,159458,4.0,68.2,65.5,1997-03-01
207,3950728,3810715,140013,3.5,68.0,65.6,1997-04-01
208,3981621,3832942,148679,3.7,68.5,65.9,1997-05-01
209,4002458,3840196,162262,4.1,68.7,65.9,1997-06-01
210,4022794,3858465,164329,4.1,69.0,66.1,1997-07-01
211,3978610,3828608,150002,3.8,68.1,65.5,1997-08-01
212,3955249,3819210,136039,3.4,67.6,65.2,1997-09-01
213,3967324,3833124,134200,3.4,67.6,65.4,1997-10-01
214,3976061,3836013,140048,3.5,67.7,65.3,1997-11-01
215,3947329,3810417,136912,3.5,67.1,64.8,1997-12-01
216,3911742,3744813,166929,4.3,66.4,63.6,1998-01-01
217,3931764,3767099,164665,4.2,66.6,63.8,1998-02-01
218,3950742,3796164,154578,3.9,66.9,64.2,1998-03-01
219,3946591,3814238,132353,3.4,66.7,64.4,1998-04-01
220,3971318,3834647,136671,3.4,67.0,64.7,1998-05-01
221,4003041,3852543,150498,3.8,67.4,64.9,1998-06-01
222,4015934,3870762,145172,3.6,67.5,65.1,1998-07-01
223,3993424,3849582,143842,3.6,67.1,64.6,1998-08-01
224,3977738,3854556,123182,3.1,66.7,64.6,1998-09-01
225,3990907,3864238,126669,3.2,66.8,64.7,1998-10-01
226,3992149,3864770,127379,3.2,66.7,64.6,1998-11-01
227,3979869,3864584,115285,2.9,66.4,64.5,1998-12-01
228,3976223,3833201,143022,3.6,66.3,63.9,1999-01-01
229,3995392,3853333,142059,3.6,66.5,64.2,1999-02-01
230,4011914,3883149,128765,3.2,66.7,64.6,1999-03-01
231,4008346,3894265,114081,2.8,66.6,64.7,1999-04-01
232,4035587,3908507,127080,3.1,66.9,64.8,1999-05-01
233,4064709,3923363,141346,3.5,67.3,65.0,1999-06-01
234,4106063,3960520,145543,3.5,67.9,65.5,1999-07-01
235,4070868,3935349,135519,3.3,67.3,65.0,1999-08-01
236,4049568,3919510,130058,3.2,66.8,64.7,1999-09-01
237,4084789,3953966,130823,3.2,67.3,65.2,1999-10-01
238,4082596,3946462,136134,3.3,67.2,65.0,1999-11-01
239,4068649,3943935,124714,3.1,66.9,64.9,1999-12-01
240,4043918,3892940,150978,3.7,66.4,63.9,2000-01-01
241,4074548,3918319,156229,3.8,66.9,64.3,2000-02-01
242,4105277,3960987,144290,3.5,67.3,64.9,2000-03-01
243,4105124,3978425,126699,3.1,67.4,65.3,2000-04-01
244,4119391,3973321,146070,3.5,67.6,65.2,2000-05-01
245,4170999,4012973,158026,3.8,68.3,65.7,2000-06-01
246,4161890,4001293,160597,3.9,68.1,65.4,2000-07-01
247,4163027,3985043,177984,4.3,68.0,65.1,2000-08-01
248,4128324,3979138,149186,3.6,67.3,64.9,2000-09-01
249,4152972,3993085,159887,3.8,67.6,65.0,2000-10-01
250,4152759,3986953,165806,4.0,67.6,64.9,2000-11-01
251,4151348,3991254,160094,3.9,67.5,64.9,2000-12-01
252,4152711,3953826,198885,4.8,67.4,64.2,2001-01-01
253,4179511,3971721,207790,5.0,67.8,64.4,2001-02-01
254,4200906,3990032,210874,5.0,68.0,64.6,2001-03-01
255,4169066,3977465,191601,4.6,67.4,64.3,2001-04-01
256,4197603,3979122,218481,5.2,67.8,64.3,2001-05-01
257,4215129,3983666,231463,5.5,68.0,64.3,2001-06-01
258,4232159,3985780,246379,5.8,68.2,64.2,2001-07-01
259,4184478,3934579,249899,6.0,67.3,63.3,2001-08-01
260,4177427,3943904,233523,5.6,67.1,63.4,2001-09-01
261,4206949,3947672,259277,6.2,67.5,63.4,2001-10-01
262,4201232,3911226,290006,6.9,67.4,62.7,2001-11-01
263,4186336,3894499,291837,7.0,67.1,62.4,2001-12-01
264,4181292,3850822,330470,7.9,66.9,61.6,2002-01-01
265,4202622,3890992,311630,7.4,67.2,62.2,2002-02-01
266,4211695,3906403,305292,7.2,67.3,62.4,2002-03-01
267,4212803,3922159,290644,6.9,67.2,62.6,2002-04-01
268,4221777,3935443,286334,6.8,67.3,62.7,2002-05-01
269,4233834,3934818,299016,7.1,67.4,62.6,2002-06-01
270,4253919,3951326,302593,7.1,67.6,62.8,2002-07-01
271,4211222,3930141,281081,6.7,66.9,62.4,2002-08-01
272,4204909,3943817,261092,6.2,66.7,62.6,2002-09-01
273,4213818,3947054,266764,6.3,66.8,62.5,2002-10-01
274,4192780,3906252,286528,6.8,66.4,61.8,2002-11-01
275,4170624,3887394,283230,6.8,65.9,61.5,2002-12-01
276,4215253,3910659,304594,7.2,66.6,61.8,2003-01-01
277,4242849,3943572,299277,7.1,67.0,62.3,2003-02-01
278,4264810,3980875,283935,6.7,67.3,62.8,2003-03-01
279,4288409,4002511,285898,6.7,67.6,63.1,2003-04-01
280,4305240,4018160,287080,6.7,67.8,63.3,2003-05-01
281,4334500,4021333,313167,7.2,68.2,63.3,2003-06-01
282,4325525,4010337,315188,7.3,68.0,63.0,2003-07-01
283,4284554,3990428,294126,6.9,67.2,62.6,2003-08-01
284,4273453,4005823,267630,6.3,67.0,62.8,2003-09-01
285,4316965,4046377,270588,6.3,67.6,63.3,2003-10-01
286,4303902,4029600,274302,6.4,67.3,63.0,2003-11-01
287,4269341,4015720,253621,5.9,66.7,62.7,2003-12-01
288,4261828,3981041,280787,6.6,66.5,62.1,2004-01-01
289,4254133,3980761,273372,6.4,66.3,62.0,2004-02-01
290,4276279,4009760,266519,6.2,66.6,62.4,2004-03-01
291,4270409,4026437,243972,5.7,66.4,62.6,2004-04-01
292,4282870,4034931,247939,5.8,66.5,62.7,2004-05-01
293,4308808,4043471,265337,6.2,66.9,62.7,2004-06-01
294,4340188,4083415,256773,5.9,67.3,63.3,2004-07-01
295,4297755,4054204,243551,5.7,66.5,62.7,2004-08-01
296,4277520,4053562,223958,5.2,66.1,62.6,2004-09-01
297,4304251,4069821,234430,5.4,66.4,62.8,2004-10-01
298,4300263,4055922,244341,5.7,66.2,62.5,2004-11-01
299,4281142,4041353,239789,5.6,65.8,62.1,2004-12-01
300,4271897,4014579,257318,6.0,65.6,61.6,2005-01-01
301,4290843,4024440,266403,6.2,65.8,61.7,2005-02-01
302,4310716,4065643,245073,5.7,66.0,62.3,2005-03-01
303,4319953,4088515,231438,5.4,66.1,62.5,2005-04-01
304,4346537,4103376,243161,5.6,66.4,62.6,2005-05-01
305,4365704,4108925,256779,5.9,66.5,62.6,2005-06-01
306,4406058,4143160,262898,6.0,67.1,63.1,2005-07-01
307,4371956,4127630,244326,5.6,66.4,62.7,2005-08-01
308,4362614,4134165,228449,5.2,66.1,62.7,2005-09-01
309,4398841,4169258,229583,5.2,66.5,63.0,2005-10-01
310,4382181,4144522,237659,5.4,66.1,62.5,2005-11-01
311,4358667,4137136,221531,5.1,65.6,62.3,2005-12-01
312,4354732,4122765,231967,5.3,65.4,62.0,2006-01-01
313,4369262,4131485,237777,5.4,65.5,62.0,2006-02-01
314,4392820,4173645,219175,5.0,65.8,62.5,2006-03-01
315,4421280,4211837,209443,4.7,66.1,63.0,2006-04-01
316,4448477,4224743,223734,5.0,66.4,63.0,2006-05-01
317,4483198,4243739,239459,5.3,66.8,63.2,2006-06-01
318,4529118,4278140,250978,5.5,67.4,63.6,2006-07-01
319,4494478,4254062,240416,5.3,66.7,63.1,2006-08-01
320,4475303,4256512,218791,4.9,66.3,63.0,2006-09-01
321,4524277,4308381,215896,4.8,66.8,63.7,2006-10-01
322,4531143,4299616,231527,5.1,66.8,63.4,2006-11-01
323,4509144,4288718,220426,4.9,66.4,63.1,2006-12-01
324,4479354,4234293,245061,5.5,65.8,62.2,2007-01-01
325,4486552,4248912,237640,5.3,65.8,62.3,2007-02-01
326,4507566,4291895,215671,4.8,65.9,62.8,2007-03-01
327,4495952,4279179,216773,4.8,65.7,62.5,2007-04-01
328,4527568,4298831,228737,5.1,66.0,62.6,2007-05-01
329,4563793,4325465,238328,5.2,66.4,62.9,2007-06-01
330,4582857,4332994,249863,5.5,66.5,62.9,2007-07-01
331,4530390,4295969,234421,5.2,65.7,62.3,2007-08-01
332,4536474,4317347,219127,4.8,65.6,62.5,2007-09-01
333,4552159,4330934,221225,4.9,65.7,62.6,2007-10-01
334,4555869,4325485,230384,5.1,65.7,62.4,2007-11-01
335,4524584,4290996,233588,5.2,65.1,61.8,2007-12-01
336,4517945,4265583,252362,5.6,64.9,61.3,2008-01-01
337,4517738,4267500,250238,5.5,64.9,61.3,2008-02-01
338,4542574,4298353,244221,5.4,65.1,61.6,2008-03-01
339,4536295,4308068,228227,5.0,64.9,61.7,2008-04-01
340,4568976,4311896,257080,5.6,65.3,61.6,2008-05-01
341,4595217,4324703,270514,5.9,65.6,61.7,2008-06-01
342,4626953,4341126,285827,6.2,65.9,61.9,2008-07-01
343,4576468,4296785,279683,6.1,65.1,61.1,2008-08-01
344,4574085,4320906,253179,5.5,65.0,61.4,2008-09-01
345,4599613,4335888,263725,5.7,65.3,61.5,2008-10-01
346,4644278,4271356,372922,8.0,65.8,60.5,2008-11-01
347,4641581,4217100,424481,9.1,65.7,59.7,2008-12-01
348,4629126,4125727,503399,10.9,65.4,58.3,2009-01-01
349,4649382,4111759,537623,11.6,65.7,58.1,2009-02-01
350,4645865,4107934,537931,11.6,65.5,57.9,2009-03-01
351,4639786,4116909,522877,11.3,65.4,58.0,2009-04-01
352,4640320,4112322,527998,11.4,65.3,57.9,2009-05-01
353,4637009,4105309,531700,11.5,65.2,57.7,2009-06-01
354,4655645,4129122,526523,11.3,65.4,58.0,2009-07-01
355,4593362,4087626,505736,11.0,64.4,57.3,2009-08-01
356,4575225,4103465,471760,10.3,64.1,57.5,2009-09-01
357,4578969,4106394,472575,10.3,64.1,57.5,2009-10-01
358,4573157,4093684,479473,10.5,63.9,57.2,2009-11-01
359,4540533,4048640,491893,10.8,63.4,56.6,2009-12-01
360,4590470,4042200,548270,11.9,64.1,56.4,2010-01-01
361,4605756,4053484,552272,12.0,64.2,56.5,2010-02-01
362,4641829,4105448,536381,11.6,64.7,57.2,2010-03-01
363,4663745,4160116,503629,10.8,63.9,57.0,2010-04-01
364,4675195,4173192,502003,10.7,64.0,57.1,2010-05-01
365,4661938,4161257,500681,10.7,63.7,56.9,2010-06-01
366,4672184,4177460,494724,10.6,63.7,57.0,2010-07-01
367,4618892,4140476,478416,10.4,62.9,56.4,2010-08-01
368,4607009,4158757,448252,9.7,62.7,56.6,2010-09-01
369,4636632,4182350,454282,9.8,63.0,56.9,2010-10-01
370,4632460,4151606,480854,10.4,62.9,56.4,2010-11-01
371,4598225,4123044,475181,10.3,62.4,55.9,2010-12-01
372,4610889,4091794,519095,11.3,62.5,55.5,2011-01-01
373,4621488,4125065,496423,10.7,62.6,55.9,2011-02-01
374,4651087,4172512,478575,10.3,62.9,56.5,2011-03-01
375,4637319,4183945,453374,9.8,62.7,56.6,2011-04-01
376,4666606,4197006,469600,10.1,63.0,56.7,2011-05-01
377,4680189,4186372,493817,10.6,63.1,56.5,2011-06-01
378,4700639,4203555,497084,10.6,63.4,56.7,2011-07-01
379,4656490,4168528,487962,10.5,62.7,56.1,2011-08-01
380,4664644,4202853,461791,9.9,62.7,56.5,2011-09-01
381,4688592,4226070,462522,9.9,63.0,56.8,2011-10-01
382,4672233,4213917,458316,9.8,62.7,56.6,2011-11-01
383,4644302,4189234,455068,9.8,62.3,56.2,2011-12-01
384,4653493,4176270,477223,10.3,62.3,55.9,2012-01-01
385,4672244,4207068,465176,10.0,62.5,56.3,2012-02-01
386,4692899,4247669,445230,9.5,62.8,56.8,2012-03-01
387,4677711,4257163,420548,9.0,62.5,56.9,2012-04-01
388,4727531,4286312,441219,9.3,63.1,57.2,2012-05-01
389,4741610,4279480,462130,9.7,63.2,57.1,2012-06-01
390,4762018,4291745,470273,9.9,63.4,57.2,2012-07-01
391,4712463,4252353,460110,9.8,62.7,56.6,2012-08-01
392,4738314,4313277,425037,9.0,63.0,57.3,2012-09-01
393,4785809,4346291,439518,9.2,63.5,57.7,2012-10-01
394,4753077,4316867,436210,9.2,63.0,57.3,2012-11-01
395,4725271,4282103,443168,9.4,62.6,56.7,2012-12-01
396,4726504,4249743,476761,10.1,62.6,56.3,2013-01-01
397,4726791,4282147,444644,9.4,62.5,56.6,2013-02-01
398,4715344,4312599,402745,8.5,62.3,57.0,2013-03-01
399,4701679,4330858,370821,7.9,62.1,57.2,2013-04-01
400,4736118,4355105,381013,8.0,62.5,57.4,2013-05-01
401,4734764,4344640,390124,8.2,62.4,57.2,2013-06-01
402,4743761,4365096,378665,8.0,62.4,57.4,2013-07-01
403,4674629,4325756,348873,7.5,61.4,56.9,2013-08-01
404,4673821,4374065,299756,6.4,61.4,57.4,2013-09-01
405,4675179,4373994,301185,6.4,61.3,57.4,2013-10-01
406,4672929,4372635,300294,6.4,61.2,57.3,2013-11-01
407,4635178,4349911,285267,6.2,60.7,57.0,2013-12-01
408,4637447,4330827,306620,6.6,60.7,56.6,2014-01-01
409,4643486,4334654,308832,6.7,60.7,56.6,2014-02-01
410,4690814,4393822,296992,6.3,61.2,57.4,2014-03-01
411,4673840,4410436,263404,5.6,61.0,57.5,2014-04-01
412,4724822,4433777,291045,6.2,61.6,57.8,2014-05-01
413,4726117,4430466,295651,6.3,61.5,57.7,2014-06-01
414,4750427,4437552,312875,6.6,61.8,57.7,2014-07-01
415,4688807,4382217,306590,6.5,60.9,56.9,2014-08-01
416,4700444,4427325,273119,5.8,61.0,57.4,2014-09-01
417,4751625,4478818,272807,5.7,61.6,58.0,2014-10-01
418,4717632,4447052,270580,5.7,61.0,57.5,2014-11-01
419,4673975,4420814,253161,5.4,60.4,57.1,2014-12-01
420,4692665,4409608,283057,6.0,60.6,56.9,2015-01-01
421,4717516,4445753,271763,5.8,60.8,57.3,2015-02-01
422,4730557,4467650,262907,5.6,61.0,57.6,2015-03-01
423,4738302,4485544,252758,5.3,61.0,57.7,2015-04-01
424,4804667,4519558,285109,5.9,61.8,58.1,2015-05-01
425,4804879,4514669,290210,6.0,61.7,58.0,2015-06-01
426,4816272,4520813,295459,6.1,61.8,58.0,2015-07-01
427,4749884,4469716,280168,5.9,60.9,57.3,2015-08-01
428,4761128,4506580,254548,5.3,60.9,57.7,2015-09-01
429,4802489,4545291,257198,5.4,61.4,58.1,2015-10-01
430,4783126,4524511,258615,5.4,61.0,57.7,2015-11-01
431,4764369,4516894,247475,5.2,60.7,57.6,2015-12-01
432,4759862,4500590,259272,5.4,60.6,57.3,2016-01-01
433,4800149,4548987,251162,5.2,61.0,57.8,2016-02-01
434,4838282,4593928,244354,5.1,61.4,58.3,2016-03-01
435,4828318,4598772,229546,4.8,61.2,58.3,2016-04-01
436,4852011,4613896,238115,4.9,61.5,58.4,2016-05-01
437,4871799,4612397,259402,5.3,61.6,58.3,2016-06-01
438,4888994,4628232,260762,5.3,61.8,58.5,2016-07-01
439,4829724,4572852,256872,5.3,60.9,57.7,2016-08-01
440,4863631,4623827,239804,4.9,61.3,58.2,2016-09-01
441,4898085,4644954,253131,5.2,61.6,58.4,2016-10-01
442,4866574,4630597,235977,4.8,61.1,58.2,2016-11-01
443,4840784,4612436,228348,4.7,60.7,57.9,2016-12-01
444,4779210,4534074,245136,5.1,60.6,57.5,2017-01-01
445,4825860,4592121,233739,4.8,61.1,58.2,2017-02-01
446,4852563,4636660,215903,4.4,61.4,58.7,2017-03-01
447,4841113,4640975,200138,4.1,61.2,58.7,2017-04-01
448,4856458,4638586,217872,4.5,61.3,58.6,2017-05-01
449,4895528,4665293,230235,4.7,61.8,58.9,2017-06-01
450,4918368,4683785,234583,4.8,62.0,59.0,2017-07-01
451,4872363,4634547,237816,4.9,61.3,58.3,2017-08-01
452,4916308,4709882,206426,4.2,61.8,59.2,2017-09-01
453,4907630,4701684,205946,4.2,61.6,59.0,2017-10-01
454,4879834,4669282,210552,4.3,61.2,58.6,2017-11-01
455,4845563,4647652,197911,4.1,60.7,58.2,2017-12-01
456,4829331,4617244,212087,4.4,60.5,57.8,2018-01-01
457,4886448,4676551,209897,4.3,61.1,58.5,2018-02-01
458,4905547,4707395,198152,4.0,61.3,58.8,2018-03-01
459,4899496,4719039,180457,3.7,61.2,58.9,2018-04-01
460,4922278,4733819,188459,3.8,61.4,59.0,2018-05-01
461,4951599,4738589,213010,4.3,61.7,59.0,2018-06-01
462,4963644,4755910,207734,4.2,61.8,59.2,2018-07-01
463,4891841,4688866,202975,4.1,60.8,58.3,2018-08-01
464,4909155,4729709,179446,3.7,61.0,58.7,2018-09-01
465,4948506,4760767,187739,3.8,61.4,59.0,2018-10-01
466,4924709,4738721,185988,3.8,61.0,58.7,2018-11-01
467,4910056,4720787,189269,3.9,60.8,58.4,2018-12-01
468,4942220,4720298,221922,4.5,61.1,58.4,2019-01-01
469,4975249,4768901,206348,4.1,61.5,58.9,2019-02-01
470,4989994,4789820,200174,4.0,61.6,59.1,2019-03-01
471,4966025,4792110,173915,3.5,61.3,59.1,2019-04-01
472,4990481,4800740,189741,3.8,61.5,59.2,2019-05-01
473,5015390,4809714,205676,4.1,61.7,59.2,2019-06-01
474,5046716,4837190,209526,4.2,62.1,59.5,2019-07-01
475,5003519,4796271,207248,4.1,61.5,58.9,2019-08-01
476,5019778,4847767,172011,3.4,61.6,59.5,2019-09-01
477,5047436,4866177,181259,3.6,61.9,59.6,2019-10-01
478,5017942,4839384,178558,3.6,61.4,59.3,2019-11-01
479,4995091,4822805,172286,3.4,61.1,59.0,2019-12-01
480,5007116,4806237,200879,4.0,61.2,58.7,2020-01-01
481,5032238,4842010,190228,3.8,61.5,59.1,2020-02-01
482,4802348,4580177,222171,4.6,58.6,55.9,2020-03-01
483,4599815,3967181,632634,13.8,56.3,48.5,2020-04-01
484,4723232,4161222,562010,11.9,57.8,50.9,2020-05-01
485,4814519,4338152,476367,9.9,58.8,53.0,2020-06-01
486,4847670,4401101,446569,9.2,59.2,53.7,2020-07-01
487,4791173,4458796,332377,6.9,58.4,54.4,2020-08-01
488,4819418,4516613,302805,6.3,58.7,55.0,2020-09-01
489,4867351,4601091,266260,5.5,59.2,55.9,2020-10-01
490,4839015,4572515,266500,5.5,58.8,55.5,2020-11-01
491,4829954,4557515,272439,5.6,58.6,55.3,2020-12-01
492,4822297,4524776,297521,6.2,58.4,54.8,2021-01-01
493,4846771,4557086,289685,6.0,58.7,55.2,2021-02-01
494,4873624,4608039,265585,5.4,58.9,55.7,2021-03-01
495,4872773,4626080,246693,5.1,58.8,55.9,2021-04-01
496,4873093,4625686,247407,5.1,58.8,55.8,2021-05-01
497,4927696,4658333,269363,5.5,59.3,56.1,2021-06-01
498,4966663,4713112,253551,5.1,59.7,56.7,2021-07-01
499,4947330,4704567,242763,4.9,59.4,56.5,2021-08-01
500,4982627,4773791,208836,4.2,59.8,57.3,2021-09-01
501,5042513,4832571,209942,4.2,60.4,57.9,2021-10-01
502,5061524,4863398,198126,3.9,60.6,58.2,2021-11-01
503,5054462,4885647,168815,3.3,60.4,58.4,2021-12-01
504,5088112,4880507,207605,4.1,60.8,58.3,2022-01-01
505,5123896,4926577,197319,3.9,61.1,58.8,2022-02-01
506,5167180,4982869,184311,3.6,61.6,59.4,2022-03-01
507,5142669,4975070,167599,3.3,61.2,59.2,2022-04-01
508,5168199,4986425,181774,3.5,61.4,59.3,2022-05-01
509,5174549,4970876,203673,3.9,61.4,59.0,2022-06-01
510,5203807,4998621,205186,3.9,61.7,59.2,2022-07-01
511,5167561,4954494,213067,4.1,61.2,58.6,2022-08-01
512,5169696,4992230,177466,3.4,61.1,59.0,2022-09-01
513,5180543,4989623,190920,3.7,61.1,58.9,2022-10-01
514,5147404,4960489,186915,3.6,60.7,58.5,2022-11-01
515,5137628,4969039,168589,3.3,60.5,58.5,2022-12-01
516,5165082,4970438,194644,3.8,60.7,58.4,2023-01-01
517,5191260,4997579,193681,3.7,60.9,58.7,2023-02-01
518,5228240,5047507,180733,3.5,61.3,59.2,2023-03-01
519,5208232,5055035,153197,2.9,61.0,59.2,2023-04-01
520,5234980,5058037,176943,3.4,61.2,59.1,2023-05-01
521,5262543,5073585,188958,3.6,61.4,59.2,2023-06-01
522,5277157,5087090,190067,3.6,61.5,59.3,2023-07-01
523,5246595,5051032,195563,3.7,61.1,58.8,2023-08-01
524,5260391,5090363,170028,3.2,61.1,59.2,2023-09-01
525,5257068,5076774,180294,3.4,61.0,58.9,2023-10-01
526,5244914,5068451,176463,3.4,60.8,58.7,2023-11-01
527,5203199,5034552,168647,3.2,60.2,58.3,2023-12-01
528,5238065,5048403,189662,3.6,60.5,58.3,2024-01-01
529,5243488,5049318,194170,3.7,60.5,58.3,2024-02-01
530,5289831,5094226,195605,3.7,61.0,58.7,2024-03-01
531,5256726,5083162,173564,3.3,60.5,58.5,2024-04-01
532,5286550,5101102,185448,3.5,60.8,58.6,2024-05-01
533,5290496,5075390,215106,4.1,60.7,58.3,2024-06-01
